11111111
10000001
10000001
10000002
10000001
11111111