11111111111111
10100000010001
10111000010001
10000000011002
10010000000001
11110001100001
10010001000001
10000001000001
11111111111111